.......R..
..H....R..
.......R..
....W..R..
..........
RRRRRRRRRR
